█████████████████████████████
█           █               █
█  $        █              HD
█           ████████        █
█       █                   █
█       █           X       █
█       █                   █
█████████████████████████████