█████████████████████████████
█           █               █
█  $        █               D
█           ████████        █
█       █                   █
█       █           X       █
█   H   █                   █
█████████████████████████████