███████████████████████████████████████d█████████
█                                      H        █
█    ███  █ █  █ █                              █
█     █   ███   █                               █
█     █   █ █  █ █                              █
█                                               █
█     █████  █████                              █
█     █      █                                  █
█     █   █  █   █                              █
█     █████  █████                              █
█                                               █
██████████████████████████                      █
█              █         █                      █
█   W   $$$    █       X                        █
█       $$$    █       X                        █
█            X            █                     █
█████████████████████████████████████████████████