█████████████████████████████████████
█                           █   █►$◀︎█
dH          █               █X█ █►$◀︎█
█           █               █ █ █►$◀︎█
█           ████████        █ █ █► ◀︎█
█                           █ █X█► ◀︎█
█                           █ █ █► ◀︎█
█                             █    ◀︎█
████████████████████████████████   ◀︎█
█             X                    ◀︎█
█ T        B    X               P  ◀︎█
█             X                    ◀︎█
█████████████████████████████████████
             █  T  █
             █ $$$ █ 
             █     █
             ███G███