█████████████████████████████████████
█                           █   █►$◀︎█
D H         █               █X█ █►$◀︎█
█           █               █ █ █►$◀︎█
█           ████████        █ █ █► ◀︎█
█                           █ █X█► ◀︎█
█                           █ █ █► ◀︎█
█                             █    ◀︎█
████████████████████████████████   ◀︎█
█             X                    ◀︎█
█ ♨︎        B    X                  ◀︎█
█             X                    ◀︎█
█████████████████████████████████████
             █ ♨︎   █
             █ $$$ █ 
             ███d███