█████████████████████████████████████
█                           █   █►$◀︎█
d           █               █X█ █►$◀︎█
█           █               █ █ █►$◀︎█
█           ████████        █ █ █► ◀︎█
█                           █ █X█► ◀︎█
█                           █ █ █► ◀︎█
█                             █    ◀︎█
█████████████████ ██████████████   ◀︎█
█             X                    ◀︎█
█ T        B    X                  ◀︎█
█             X                    ◀︎█
█████████████████████████████████████
             █  T  █
             █ $$$ █ 
             █  H  █
             ███G███